%%%%%%%%          %%%%   %%%%%%%%
%%    %%%%%%%       K   %%   %
%   O   %%%%%%%O    %%%%%%   %
%            K    %%%        %
%K                         %%%
%%%%%%%%%%%%%%%%%%%    %%%%%%%
%%%%%%  K             %%%%%%%%
%                       O    %
%%%      O            K      %
%%%%%                        %
%%%%%%%%%%%%%%%%           K %
%%%%%%%E          %%%%%%%%%%%%
