%%%%%%%%%%A%%%%%%%%
%%           K   %%
%   O   O    %%%%%%
%     S      K    %
%K               %%
%%%%%%%%%E%%%%%%%%%
